avg_value_per_transaction,total_gas_fee,total_unique_addresses,total_value,transaction_count,transaction_time,unique_from_addresses,unique_to_addresses
2017.0251349202401,145233.44663028046,255897,2905879703.2765107,1440676,2024-01-01 00:00:00+00:00,246275,9622
581.2958199869385,66150.69911896223,370244,694273569.0805061,1194355,2024-01-02 00:00:00+00:00,362828,7416
670.6377189672263,51581.9051337765,232915,654953514.6337374,976613,2024-01-03 00:00:00+00:00,226825,6090
396.47260353330984,25110.079753430535,111322,295310239.9061731,744844,2024-01-04 00:00:00+00:00,104426,6896
150.5577648253758,16727.767694560378,93226,107358074.80626547,713069,2024-01-05 00:00:00+00:00,87294,5932
131.00192835156597,14473.70173281952,89154,90823374.92228067,693298,2024-01-06 00:00:00+00:00,83840,5314
252.48460117575968,19096.82949496805,102564,181528601.2228261,718969,2024-01-07 00:00:00+00:00,97259,5305
404.8758205292012,22798.95613507159,111612,301369721.88670194,744351,2024-01-08 00:00:00+00:00,104620,6992
716.5759842379939,36715.67994949163,125949,581878330.1768707,812026,2024-01-09 00:00:00+00:00,118844,7105
270.57012660494354,34706.381394601645,126142,223325065.08805057,825387,2024-01-10 00:00:00+00:00,119599,6543
191.30327459743089,22650.475765138315,111387,143571959.76574206,750494,2024-01-11 00:00:00+00:00,103734,7653
325.155321550981,25531.861453006888,119997,250375450.39002016,770018,2024-01-12 00:00:00+00:00,112767,7230
1255.2951187817755,42979.104911664486,129378,1119421975.124912,891760,2024-01-13 00:00:00+00:00,122100,7278
364.28748656247706,25162.130861679216,97455,274247641.3712766,752833,2024-01-14 00:00:00+00:00,90670,6785
233.79268497383208,20350.36417458125,105305,176701914.05933774,755806,2024-01-15 00:00:00+00:00,98443,6862
885.6862470379324,72119.82819723777,193157,937838110.3223829,1058883,2024-01-16 00:00:00+00:00,180745,12412
258.9254041730049,17903.41108424049,107206,189044026.8407537,730110,2024-01-17 00:00:00+00:00,98431,8775
476.861533710918,19761.820220235768,121100,352893748.2381945,740034,2024-01-18 00:00:00+00:00,114921,6179
152.08798516835358,17870.795404521054,105160,107872205.68028386,709275,2024-01-19 00:00:00+00:00,94896,10264
179.1709994469468,13852.300576410047,90551,120309563.53763604,671479,2024-01-20 00:00:00+00:00,84350,6201
104.75821324164801,10018.924288425587,84828,54316714.53292643,518496,2024-01-21 00:00:00+00:00,79228,5600
324.31948560591115,24321.65944878042,107816,223123373.7902276,687974,2024-01-22 00:00:00+00:00,101903,5913
384.98870383310026,22194.377472802084,103495,273997615.4841352,711703,2024-01-23 00:00:00+00:00,97264,6231
359.10937365965253,17733.32581648322,105098,249099089.91398302,693658,2024-01-24 00:00:00+00:00,97819,7279
812.9071742036913,31921.791416458098,118711,619224723.7850413,761741,2024-01-25 00:00:00+00:00,111995,6716
168.95161923964892,16480.597538743063,104094,114994554.31279987,680636,2024-01-26 00:00:00+00:00,94351,9743
82.84217541964642,10025.178296853244,85753,52891415.31842871,638460,2024-01-27 00:00:00+00:00,78074,7679
48.2539251918193,9201.29039746215,91984,30637719.960268114,634927,2024-01-28 00:00:00+00:00,82464,9520
119.04621175689142,12334.529216767354,102364,75079945.78462726,630679,2024-01-29 00:00:00+00:00,92206,10158
273.56733943420227,19536.451071578587,113640,190627740.5991904,696822,2024-01-30 00:00:00+00:00,106456,7184
121.72005150214345,11122.73611643408,102187,66795460.6224727,548763,2024-01-31 00:00:00+00:00,93228,8959
107.53206463167746,9648.989143879848,92766,63010563.91222441,585970,2024-02-01 00:00:00+00:00,87523,5243
33.10901193488093,7723.800946466672,87493,21609954.10878944,652691,2024-02-02 00:00:00+00:00,82470,5023
26.95821314825101,6998.142556676676,85468,17180388.364740476,637297,2024-02-03 00:00:00+00:00,79438,6030
35.640490914588085,7236.319111089374,84490,22609578.98590503,634379,2024-02-04 00:00:00+00:00,77951,6539
146.8233480399748,13919.830451241804,104208,101948406.76838107,694361,2024-02-05 00:00:00+00:00,95527,8681
105.20021874602882,13790.077725714827,113837,75640850.88233192,719018,2024-02-06 00:00:00+00:00,102921,10916
87.33948500615654,9270.839706840565,94519,59445436.98231365,680625,2024-02-07 00:00:00+00:00,88756,5763
95.25323228871619,12492.487244475356,89174,64681993.14535136,679053,2024-02-08 00:00:00+00:00,83184,5990
75.40929708804713,11118.726845691994,81514,50163320.153130256,665214,2024-02-09 00:00:00+00:00,75903,5611
39.30233716782994,10061.907977283181,83050,26143875.38170376,665199,2024-02-10 00:00:00+00:00,76329,6721
32.02580307895963,8192.944418791669,84252,21110192.40913263,659162,2024-02-11 00:00:00+00:00,75265,8987
108.8152073707889,10963.635247044569,84865,74072687.96144225,680720,2024-02-12 00:00:00+00:00,77297,7568
356.80737505195066,18091.071354901112,101832,259343299.7122417,726844,2024-02-13 00:00:00+00:00,92268,9564
814.925312837307,41551.72319548402,138560,677486528.9766675,831348,2024-02-14 00:00:00+00:00,130688,7872
125.20538128811866,14199.85859392031,96311,87290186.90492843,697176,2024-02-15 00:00:00+00:00,89405,6906
120.8995102831251,17825.960706222042,119752,89540958.00442037,740623,2024-02-16 00:00:00+00:00,113688,6064
100.10397340974927,14770.569772449579,109655,73943501.72666189,738667,2024-02-17 00:00:00+00:00,105030,4625
85.18461665382306,9960.242665446049,78047,59776856.59833895,701733,2024-02-18 00:00:00+00:00,73059,4988
59.44554138086926,39143.06762416804,387717,66076988.74961156,1111555,2024-02-19 00:00:00+00:00,382270,5447
180.44379535573475,16363.406725402681,100378,135269691.18840322,749650,2024-02-20 00:00:00+00:00,89880,10498
139.81175485545637,15304.73413373793,88718,100907596.13762209,721739,2024-02-21 00:00:00+00:00,83029,5689
94.76699826383516,13293.732899861021,87166,65303559.435615934,689096,2024-02-22 00:00:00+00:00,82096,5070
376.51502198247357,16588.590884907728,90927,264975458.8403427,703758,2024-02-23 00:00:00+00:00,85900,5027
648.7172820807037,31738.917896051127,94812,506350436.0725135,780541,2024-02-24 00:00:00+00:00,89985,4827
111.18971146560598,16286.772775359983,87977,78033050.69627562,701801,2024-02-25 00:00:00+00:00,83389,4588
278.4223314147083,17462.487786697176,88021,200623614.61447996,720573,2024-02-26 00:00:00+00:00,83168,4853
406.70054643726894,29507.832047238502,113282,306695322.2716315,754106,2024-02-27 00:00:00+00:00,106737,6545
526.0104174520905,46981.15488058723,127461,481221156.4164519,914851,2024-02-28 00:00:00+00:00,120062,7399
623.5856157549314,32228.54706931581,123814,522540426.16359615,837961,2024-02-29 00:00:00+00:00,117197,6617
168.47743781736762,14833.7079666577,95357,118684268.0252971,704452,2024-03-01 00:00:00+00:00,90275,5082
327.9291656102471,34285.97768216853,150608,278593206.4316893,849553,2024-03-02 00:00:00+00:00,141888,8720
231.3483173372095,31979.840746619677,158092,196562090.29743016,849637,2024-03-03 00:00:00+00:00,153206,4886
205.23799520832026,21900.501245571857,102103,154680283.1826785,753663,2024-03-04 00:00:00+00:00,97106,4997
1198.11818737316,67326.46192102606,125825,1391025998.6039116,1161009,2024-03-05 00:00:00+00:00,119597,6228
553.436128632437,22508.739404093445,102626,425663222.7428091,769128,2024-03-06 00:00:00+00:00,94846,7780
213.79377342323562,23235.46016187863,160813,168856032.59986252,789808,2024-03-07 00:00:00+00:00,155375,5438
226.7465058133436,25810.84787728654,199534,185699039.35897204,818972,2024-03-08 00:00:00+00:00,193217,6317
154.29572682433707,16142.815209488872,132226,111228240.66594766,720877,2024-03-09 00:00:00+00:00,126327,5899
387.3099906000323,26044.633617919477,153575,298880535.4762004,771683,2024-03-10 00:00:00+00:00,146940,6635
193.9887549554455,28449.94381015735,201662,163250266.78898335,841545,2024-03-11 00:00:00+00:00,192552,9110
259.4060936437222,32747.70304110337,216488,222246170.72925815,856750,2024-03-12 00:00:00+00:00,208337,8151
296.5007042814828,25677.68394019484,173081,233361472.30614325,787052,2024-03-13 00:00:00+00:00,166863,6218
297.9629582338334,30306.557273153798,184129,250091633.4380585,839338,2024-03-14 00:00:00+00:00,178066,6063
233.45598904551588,26414.260332350063,146758,186777864.7717919,800056,2024-03-15 00:00:00+00:00,141168,5590
237.63909460484408,24216.73581158875,153015,183750865.3167721,773235,2024-03-16 00:00:00+00:00,148376,4639
309.33828014422784,22055.187700636707,126838,227990355.26158553,737026,2024-03-17 00:00:00+00:00,122128,4710
204.60147076140854,30324.51410669159,184793,146800736.86542523,717496,2024-03-18 00:00:00+00:00,179568,5225
277.76167361602757,45582.22928821202,280386,250956561.06538928,903496,2024-03-19 00:00:00+00:00,275243,5143
216.34698059521983,32970.45113264497,199588,185703161.56974375,858358,2024-03-20 00:00:00+00:00,190118,9470
208.4080354161699,23558.252144091904,152852,164543562.56998333,789526,2024-03-21 00:00:00+00:00,148040,4812
262.11540209631636,21357.056215439847,127438,191113057.7456559,729118,2024-03-22 00:00:00+00:00,123220,4218
120.77265818054933,14671.684458404814,103629,80602585.1157756,667391,2024-03-23 00:00:00+00:00,99976,3653
137.72610109418508,12793.318176995383,103948,91752439.91844413,666195,2024-03-24 00:00:00+00:00,99860,4088
235.2549857910176,21403.212657043652,131641,172135602.5933183,731698,2024-03-25 00:00:00+00:00,126685,4956
240.12996168517313,26501.118448094945,153235,183399258.23705232,763750,2024-03-26 00:00:00+00:00,147898,5337
442.6397531913002,40275.9812105295,210453,377424753.074126,852668,2024-03-27 00:00:00+00:00,205755,4698
250.73287388862875,17233.175131236978,143354,185068441.54593343,738110,2024-03-28 00:00:00+00:00,131475,11879
136.31100418460792,17815.33883503753,186875,112443219.97389369,824902,2024-03-29 00:00:00+00:00,168488,18387
97.03155906958075,11396.201086653777,115050,67006598.58888622,690565,2024-03-30 00:00:00+00:00,103314,11736
81.56163910375432,11037.207364343765,122657,54549158.287343435,668809,2024-03-31 00:00:00+00:00,112147,10510
271.1318492274954,25963.295275661705,142054,218463131.85581198,805745,2024-04-01 00:00:00+00:00,133740,8314
157.69928466919947,25672.567459657643,153585,127859110.62552308,810778,2024-04-02 00:00:00+00:00,145091,8494
182.36747575719374,18514.498228149347,140836,142164565.72654164,779550,2024-04-03 00:00:00+00:00,124721,16115
77.69348623442635,15075.882480878758,176417,66271844.516592026,852991,2024-04-04 00:00:00+00:00,141697,34720
100.45534788755737,18039.440661402907,218677,91365243.91255827,909511,2024-04-05 00:00:00+00:00,175879,42798
32.89873093468312,11159.91371143714,242711,31051532.99016106,943852,2024-04-06 00:00:00+00:00,180446,62265
63.200016940704586,13107.279787472366,359199,68934849.67795904,1090741,2024-04-07 00:00:00+00:00,247403,111796
46.842761849736725,14439.413585308454,430280,56350671.43622113,1202975,2024-04-08 00:00:00+00:00,319185,111095
75.35002525007421,15273.086480410326,438676,90535541.88882391,1201533,2024-04-09 00:00:00+00:00,315280,123396
104.73251802383933,22506.270077170935,493440,135032787.54586306,1289311,2024-04-10 00:00:00+00:00,360713,132727
117.71185821349557,13934.327937451822,492966,144175249.61781958,1224815,2024-04-11 00:00:00+00:00,345686,147280
117.31644007454068,24916.686804022902,577671,143999829.73662114,1227448,2024-04-12 00:00:00+00:00,417967,159704
333.9150233747906,34289.53916919924,315853,328787090.3608176,984643,2024-04-13 00:00:00+00:00,236536,79317
397.3391285977926,33691.5107617842,408769,454937408.6793593,1144960,2024-04-14 00:00:00+00:00,275298,133471
73.16482104256549,15783.997601463909,473187,82041030.80182645,1121318,2024-04-15 00:00:00+00:00,312173,161014
98.56442467168553,17134.44885341427,626854,123131410.39224923,1249248,2024-04-16 00:00:00+00:00,382061,244793
80.9171881768949,15143.768993886,692949,107689368.13987166,1330859,2024-04-17 00:00:00+00:00,428677,264272
154.62178996203255,18149.089801169404,684379,210089883.16226646,1358734,2024-04-18 00:00:00+00:00,430493,253886
100.82004399447136,18530.13410705446,627921,129921043.95316511,1288643,2024-04-19 00:00:00+00:00,395403,232518
93.0275557869464,15170.706721554958,713260,117937265.31731823,1267767,2024-04-20 00:00:00+00:00,400196,313064
41.17868466212882,11637.910161034883,857566,57492773.59420254,1396178,2024-04-21 00:00:00+00:00,471113,386453
92.31848549696868,15643.337229488576,868397,133606635.67667413,1447236,2024-04-22 00:00:00+00:00,510190,358207
57.101727853865206,15900.038480175675,996490,91133786.63746019,1595990,2024-04-23 00:00:00+00:00,606804,389686
155.4829900516333,15965.507096477146,1054803,256267375.1689855,1648202,2024-04-24 00:00:00+00:00,639741,415062
55.26015591091162,17019.216720602257,1217036,100753852.90674707,1823264,2024-04-25 00:00:00+00:00,792981,424055
101.36910370001445,18343.575409196015,1173420,196087988.720896,1934396,2024-04-26 00:00:00+00:00,846064,327356
33.60217188391686,14425.475425095894,736702,54728226.971234486,1628711,2024-04-27 00:00:00+00:00,675603,61099
37.887320832248605,14812.036210641223,570385,52896723.96583263,1396159,2024-04-28 00:00:00+00:00,460290,110095
35.59096616241437,17273.041935747508,1279920,70766229.84005214,1988320,2024-04-29 00:00:00+00:00,887458,392462
37.485192572867675,15212.929216590368,921693,60058962.966211684,1602205,2024-04-30 00:00:00+00:00,606073,315620
47.84282214471946,17482.581041562997,1165358,91348309.71944025,1909342,2024-05-01 00:00:00+00:00,711858,453500
52.57788256964618,16154.637588915708,837651,88552353.3362732,1684213,2024-05-02 00:00:00+00:00,487756,349895
57.097595820247754,18262.11708708101,562615,81716366.21003535,1431170,2024-05-03 00:00:00+00:00,326994,235621
77.76488375776256,14226.280199963767,357956,90679220.23850033,1166069,2024-05-04 00:00:00+00:00,307982,49974
96.32631727293672,14697.030971914992,354597,108581625.64062929,1127227,2024-05-05 00:00:00+00:00,320502,34095
70.26467408421254,13476.011262516913,340918,78142749.34253609,1112120,2024-05-06 00:00:00+00:00,307527,33391
66.85112223204275,13289.734669656016,412663,80176088.46870151,1199323,2024-05-07 00:00:00+00:00,329885,82778
39.066522499387844,13314.686262158688,529288,57191396.54645636,1463949,2024-05-08 00:00:00+00:00,499424,29864
301.61191001720425,15187.09434151607,400961,535247432.5904562,1774623,2024-05-09 00:00:00+00:00,350795,50166
84.089597833828,27095.21116231722,334540,254921063.5067848,3031541,2024-05-10 00:00:00+00:00,305500,29040
8.964471766275414,20277.935760542176,450647,34744320.382296614,3875780,2024-05-11 00:00:00+00:00,422517,28130
23.0554830976889,22359.739255081407,352642,95784419.52806117,4154518,2024-05-12 00:00:00+00:00,323789,28853
31.12640300639795,26599.466149042666,432690,133102195.38710837,4276183,2024-05-13 00:00:00+00:00,406848,25842
10.82852525313116,21671.010445582142,409801,46129030.294689424,4259955,2024-05-14 00:00:00+00:00,384573,25228
10.357668491621936,22483.608720438435,277458,42796342.91477687,4131851,2024-05-15 00:00:00+00:00,250573,26885
25.623231138257626,103406.65893861947,304483,88125312.64979698,3439274,2024-05-16 00:00:00+00:00,278191,26292
5.729062883117815,263604.1266763727,302594,23792276.808866862,4152909,2024-05-17 00:00:00+00:00,277705,24889
7.412675025369507,260762.31644348626,302695,30526440.94165095,4118141,2024-05-18 00:00:00+00:00,277790,24905
11.022416823399622,272811.3195284167,292817,46554367.87464659,4223608,2024-05-19 00:00:00+00:00,268556,24261
20.648222342837954,270467.9893336682,267308,85788077.88957322,4154744,2024-05-20 00:00:00+00:00,239763,27545
63.69103960436082,81119.35317241018,353184,121005077.55940126,1899876,2024-05-21 00:00:00+00:00,331617,21567
86.60244383613306,15736.613486415657,319989,95623993.61544159,1104172,2024-05-22 00:00:00+00:00,291489,28500
41.14719652059996,117522.39834525647,315385,95339988.25646165,2317047,2024-05-23 00:00:00+00:00,278515,36870
33.10470925737037,270699.23344385653,357810,140296400.53965712,4237959,2024-05-24 00:00:00+00:00,311135,46675
4.084635151434431,269169.3136055619,368935,17540085.051154777,4294162,2024-05-25 00:00:00+00:00,283807,85128
31.335760766444853,270615.07587897545,358040,133686471.3917191,4266259,2024-05-26 00:00:00+00:00,309002,49038
29.71235860151084,274325.8752253514,400043,128280820.4104496,4317423,2024-05-27 00:00:00+00:00,371252,28791
177.66693449379196,43112.84152509261,302132,238298973.89463258,1341268,2024-05-28 00:00:00+00:00,272942,29190
104.67021974558746,22446.8091233707,360252,123926400.0721707,1183970,2024-05-29 00:00:00+00:00,331751,28501
120.1839718989913,21474.17495594158,424979,153540432.3797159,1277545,2024-05-30 00:00:00+00:00,385357,39622
84.15904861294509,18737.841529660756,309944,93239473.32208785,1107896,2024-05-31 00:00:00+00:00,281450,28494
88.06191041250307,18492.52196597113,319853,97872183.35627723,1111402,2024-06-01 00:00:00+00:00,292061,27792
104.59721612224202,16802.310465452516,320926,117988902.29958709,1128031,2024-06-02 00:00:00+00:00,292601,28325
371.2088644308452,39173.389138540886,357659,434950994.58659637,1171715,2024-06-03 00:00:00+00:00,328049,29610
252.5868816937899,26401.47506203883,291028,278192371.6517099,1101373,2024-06-04 00:00:00+00:00,263022,28006
64.24744656348706,13171.32738176112,299074,68483601.9526506,1065935,2024-06-05 00:00:00+00:00,270783,28291
95.3396906557892,16617.735004015314,320229,106160745.54524131,1113500,2024-06-06 00:00:00+00:00,280723,39506
166.82186758227832,22842.782471243616,327887,187481588.12927264,1123843,2024-06-07 00:00:00+00:00,308127,19760
89.23553544156715,13701.398391098915,248700,79188774.21280798,887413,2024-06-08 00:00:00+00:00,229801,18899
49.96592052645038,12677.739036512223,215352,37858028.76671964,757677,2024-06-09 00:00:00+00:00,198612,16740
113.09379575043357,20296.561248949154,310577,122426974.33854377,1082526,2024-06-10 00:00:00+00:00,288975,21602
189.43601597827228,25780.019901608794,361675,217074541.2734674,1145899,2024-06-11 00:00:00+00:00,332875,28800
127.56638038832324,20304.03076942269,360075,146954684.27802494,1151986,2024-06-12 00:00:00+00:00,335013,25062
71.00574698228515,16401.858640750685,372562,82292536.4996017,1158956,2024-06-13 00:00:00+00:00,330661,41901
116.78027139166733,19020.1177843714,378840,138852676.926863,1189008,2024-06-14 00:00:00+00:00,348275,30565
47.97448598046018,15125.622336603732,376000,61992151.03908946,1292190,2024-06-15 00:00:00+00:00,348363,27637
61.64433362163367,12206.70111481381,244104,62512655.705013715,1014086,2024-06-16 00:00:00+00:00,227866,16238
206.96324028821095,25649.615875511165,400391,280610074.5285608,1355845,2024-06-17 00:00:00+00:00,350256,50135
97.34143232293671,22483.71353640206,607261,142565483.04873425,1464592,2024-06-18 00:00:00+00:00,443841,163420
526.3589376744395,45958.04425400426,636031,791310657.0546677,1503367,2024-06-19 00:00:00+00:00,453608,182423
102.9861773662529,17641.523197456467,622587,142050791.17862004,1379319,2024-06-20 00:00:00+00:00,404497,218090
69.81037361438545,21149.024879682955,618931,94052514.52458665,1347257,2024-06-21 00:00:00+00:00,412341,206590
45.74583581875398,12561.500674842735,658771,62617266.0353833,1368808,2024-06-22 00:00:00+00:00,456909,201862
61.99482129852792,13572.720610196198,655219,85370464.6276949,1377058,2024-06-23 00:00:00+00:00,454695,200524
92.28152363745775,17181.829857255536,659176,131232724.23114225,1422091,2024-06-24 00:00:00+00:00,457750,201426
126.62355330865924,20378.988579121426,661399,178824999.52506608,1412257,2024-06-25 00:00:00+00:00,460503,200896
34.82302126107177,14962.437192868163,666026,47654225.08211681,1368469,2024-06-26 00:00:00+00:00,463891,202135
131.85944708996342,17824.235543335075,726719,193843672.25910908,1470078,2024-06-27 00:00:00+00:00,514679,212040
353.3756106193583,13633.34946537028,648052,468601502.7250323,1326072,2024-06-28 00:00:00+00:00,445457,202595
63.54418410650393,12312.391225466079,668221,82022388.03544094,1290793,2024-06-29 00:00:00+00:00,534224,133997
55.167698974359375,13257.664315370004,619909,66268874.368198045,1201226,2024-06-30 00:00:00+00:00,410948,208961
318.4457826659342,15376.099151572913,129808,238443922.46984738,748774,2024-07-01 00:00:00+00:00,125729,4079
201.22978006620556,14436.303321692747,123948,145691366.9168267,724005,2024-07-02 00:00:00+00:00,120615,3333
121.15359483140936,12210.43474380811,104315,83450111.50549622,688796,2024-07-03 00:00:00+00:00,100402,3913
128.81039479873678,19308.272864200924,287548,114962762.1162909,892496,2024-07-04 00:00:00+00:00,283789,3759
200.01593086834117,26834.1156268403,275865,184382685.71170586,921840,2024-07-05 00:00:00+00:00,272275,3590
77.49312117973457,12030.862725771001,178012,57337547.82649837,739905,2024-07-06 00:00:00+00:00,174835,3177
94.66816838445597,13178.347806646101,111605,64315376.232525304,679377,2024-07-07 00:00:00+00:00,108080,3525
131.59545177998163,15968.829868515082,111814,92721628.94236805,704596,2024-07-08 00:00:00+00:00,107824,3990
754.6303996614505,29259.4214057748,153870,601334025.6438227,796859,2024-07-09 00:00:00+00:00,149180,4690
184.85975611678782,15615.933412025313,123351,130233883.04402803,704501,2024-07-10 00:00:00+00:00,119810,3541
225.63769390959573,16375.756410896232,175831,174958565.30672598,775396,2024-07-11 00:00:00+00:00,171831,4000
91.77785423411352,14385.030973796178,157414,65147133.16027216,709835,2024-07-12 00:00:00+00:00,153833,3581
123.09062044014101,11999.440238409492,114411,78591268.6104817,638483,2024-07-13 00:00:00+00:00,110777,3634
32.378978834104636,9722.560999106681,186087,22971849.355472088,709468,2024-07-14 00:00:00+00:00,182018,4069
64.61121533926567,13604.808316515158,295397,60499034.53899695,936355,2024-07-15 00:00:00+00:00,291513,3884
93.60810585760971,15593.233292412964,149741,62754780.558835365,670399,2024-07-16 00:00:00+00:00,145400,4341
226.98092750710947,12997.238215360347,196881,96782624.6606839,426391,2024-07-17 00:00:00+00:00,192066,4815
112.49178314701392,11018.887944269445,340228,68104437.87753502,605417,2024-07-18 00:00:00+00:00,336353,3875
519.541171142298,13978.132093207427,141396,195085112.05807164,375495,2024-07-19 00:00:00+00:00,133162,8234
79.3462426381638,7369.657631855026,200681,32398657.794015534,408320,2024-07-20 00:00:00+00:00,197669,3012
4034.196621979247,30076.90332193269,100990,1663166138.7530742,412267,2024-07-21 00:00:00+00:00,95311,5679
415.50182389681487,21780.56820597967,198884,187238833.40809375,450633,2024-07-22 00:00:00+00:00,194515,4369
225.70474278043133,14012.641344751724,111650,90610297.51291858,401455,2024-07-23 00:00:00+00:00,108156,3494
199.43583650502552,12498.75397246934,143388,76195458.51592809,382055,2024-07-24 00:00:00+00:00,140030,3358
384.91924045895524,20741.263586289595,183817,458766766.57949615,1191852,2024-07-25 00:00:00+00:00,172679,11138
152.4891483736006,10671.963104538048,94442,121475295.4207837,796616,2024-07-26 00:00:00+00:00,90807,3635
80.75142628244765,31140.005949135655,105879,383199998.5692375,4745427,2024-07-27 00:00:00+00:00,102316,3563
8.266206719458916,20860.839749126004,102857,31477136.553229235,3807930,2024-07-28 00:00:00+00:00,99393,3464
18.315097341325966,28250.095034674472,133370,92317083.31307836,5040491,2024-07-29 00:00:00+00:00,128936,4434
40.020656012974136,46468.34369049113,108969,335690181.0463132,8387923,2024-07-30 00:00:00+00:00,105008,3961
150.47807976166098,20565.079873651648,183877,279006975.3750479,1854137,2024-07-31 00:00:00+00:00,179652,4225
180.8719688276258,20103.051084310744,180963,226668389.59083694,1253198,2024-08-01 00:00:00+00:00,177563,3400
71.82563832966511,17602.660817953318,95899,84454524.84025551,1175827,2024-08-02 00:00:00+00:00,92483,3416
130.6962747078821,16892.033395779283,95188,157275845.39894864,1203369,2024-08-03 00:00:00+00:00,92094,3094
119.42408479841377,23167.85298298385,184451,86487399.90735008,724204,2024-08-04 00:00:00+00:00,181181,3270
1217.6518046710455,57929.82524093829,229839,772105703.4311647,634094,2024-08-05 00:00:00+00:00,223128,6711
245.74279716756962,15933.12890021225,176366,105060206.38787752,427521,2024-08-06 00:00:00+00:00,168908,7458
350.9362109444194,18292.439201290923,190050,156335765.12394413,445482,2024-08-07 00:00:00+00:00,186705,3345
188.68526103226972,19434.05093286631,210724,85216679.18104775,451634,2024-08-08 00:00:00+00:00,207142,3582
382.46928470761424,15319.150641951015,222121,194172006.4601532,507680,2024-08-09 00:00:00+00:00,218434,3687
285.8156373398616,12137.018892628595,126280,98437763.65622279,344410,2024-08-10 00:00:00+00:00,123086,3194
138.02198837562787,16570.391046380424,354504,88253881.78518549,639419,2024-08-11 00:00:00+00:00,351522,2982
194.83874774096174,14790.658950076884,94851,61443178.45510274,315354,2024-08-12 00:00:00+00:00,91555,3296
144.4828053092293,11862.54054215896,94011,42577926.86218673,294692,2024-08-13 00:00:00+00:00,90819,3192
279.4389460356455,12447.307099077503,319850,144200276.51746184,516035,2024-08-14 00:00:00+00:00,316800,3050
958.5115621980931,29513.873365523756,321426,517595285.0744903,539999,2024-08-15 00:00:00+00:00,318111,3315
1442.109806941571,41702.24745654506,162246,583339185.3470767,404504,2024-08-16 00:00:00+00:00,159096,3150
1197.2378693607277,37875.108337732425,144881,477026259.4302183,398439,2024-08-17 00:00:00+00:00,141805,3076
743.7772609910506,25311.273679137903,120514,256133087.812966,344368,2024-08-18 00:00:00+00:00,116892,3622
1007.6466492915453,26390.063209766784,134226,350969373.82815385,348306,2024-08-19 00:00:00+00:00,130887,3339
366.73146598377724,13800.915940289457,102200,113102917.9611181,308408,2024-08-20 00:00:00+00:00,93920,8280
410.84565393689064,15746.784728764758,102049,126487462.32320382,307871,2024-08-21 00:00:00+00:00,98396,3653
503.41246616633504,10196.799633011686,91675,136892448.5121446,271929,2024-08-22 00:00:00+00:00,87883,3792
413.16081214876704,11452.712918534202,95706,116118433.09359282,281049,2024-08-23 00:00:00+00:00,90090,5616
333.6346244922801,10493.355124121408,200884,126251679.15803121,378413,2024-08-24 00:00:00+00:00,193763,7121
832.4386288356657,17902.439121855892,272592,423804495.2039264,509112,2024-08-25 00:00:00+00:00,268744,3848
561.6902796150755,16741.13701307062,193951,246019780.78112638,437999,2024-08-26 00:00:00+00:00,186654,7297
455.8099598717348,33649.48318591887,336830,311558414.44139755,683527,2024-08-27 00:00:00+00:00,328021,8809
637.5333416391222,39243.39132274136,528089,551305682.1155225,864748,2024-08-28 00:00:00+00:00,520736,7353
1239.2475019342464,7739.452527859833,258562,587607791.7548378,474165,2024-08-29 00:00:00+00:00,253929,4633
1163.3780102103797,4661.450990438433,136674,417468891.9399231,358842,2024-08-30 00:00:00+00:00,131300,5374
868.30205248791,4274.3376084164365,141457,273160010.9942264,314591,2024-08-31 00:00:00+00:00,137482,3975
607.2023160468324,4394.966229419678,181402,230317303.2974055,379309,2024-09-01 00:00:00+00:00,178095,3307
768.1136486400009,4169.143192923266,127169,242785362.0621227,316080,2024-09-02 00:00:00+00:00,121198,5971
598.0249315193731,4083.5003636984807,138420,196687409.8520738,328895,2024-09-03 00:00:00+00:00,134261,4159
1144.8849668793646,9194.338026775487,169427,436794222.79387695,381518,2024-09-04 00:00:00+00:00,165526,3901
1348.673558870822,7880.675036048451,198519,568440280.2664241,421481,2024-09-05 00:00:00+00:00,193781,4738
827.2442968122258,5456.783802977436,201549,343345263.6590312,415047,2024-09-06 00:00:00+00:00,197796,3753
524.4018281932657,3738.6635461963147,116798,141497247.69408506,269826,2024-09-07 00:00:00+00:00,113961,2837
300.0886590960925,3575.680109287486,109255,78929619.20411299,263021,2024-09-08 00:00:00+00:00,106228,3027
781.9552749558231,4146.586370240186,101091,217598604.13834366,278275,2024-09-09 00:00:00+00:00,97672,3419
504.055895276843,3836.272548371676,93625,133989146.19428118,265822,2024-09-10 00:00:00+00:00,90273,3352
878.090387412397,4140.407936742933,125257,283028727.9419355,322323,2024-09-11 00:00:00+00:00,121720,3537
465.137844710447,5385.865786141934,191958,184123420.41509846,395847,2024-09-12 00:00:00+00:00,188052,3906
556.3447707880957,5621.890582409854,105334,155075541.40947518,278740,2024-09-13 00:00:00+00:00,101329,4005
322.64759800133305,8412.744403320115,93092,91336372.63261259,283084,2024-09-14 00:00:00+00:00,89567,3525
378.94438578992094,4721.558710529543,85095,100151590.664804,264291,2024-09-15 00:00:00+00:00,81511,3584
323.9735328700659,5383.05637154981,252839,133563272.50221153,412266,2024-09-16 00:00:00+00:00,249289,3550
209.30708040435775,4669.797405614799,110731,53341700.13397042,254849,2024-09-17 00:00:00+00:00,106912,3819
289.87345307743124,4841.017905380387,90035,72702001.27253917,250806,2024-09-18 00:00:00+00:00,85473,4562
525.2674068719084,6180.421365990971,105792,149146528.57682848,283944,2024-09-19 00:00:00+00:00,98977,6815
489.1033903749955,5376.1364893920845,91462,130797006.86087142,267422,2024-09-20 00:00:00+00:00,81325,10137
324.0610314575319,5215.549870203902,87682,83191327.69061999,256715,2024-09-21 00:00:00+00:00,83209,4473
284.8299443007292,5886.145435533112,93643,83508436.8796982,293187,2024-09-22 00:00:00+00:00,87449,6194
237.2592770986607,4871.9200467138835,85524,69025366.96776028,290928,2024-09-23 00:00:00+00:00,78173,7351
341.97670820162267,5316.156502719756,84339,105070633.71140648,307245,2024-09-24 00:00:00+00:00,79121,5218
1256.9183817676906,6082.879041098559,156701,537976150.4176273,428012,2024-09-25 00:00:00+00:00,150440,6261
1531.8402526207515,7109.326023735077,146003,690529076.437554,450784,2024-09-26 00:00:00+00:00,139263,6740
1609.6594361682792,6597.421585960096,109180,675448511.9241685,419622,2024-09-27 00:00:00+00:00,103627,5553
287.02262938239784,5612.774114788134,141108,97525984.12472355,339785,2024-09-28 00:00:00+00:00,136261,4847
247.56832919507002,5440.016007147691,140079,86211461.98058246,348233,2024-09-29 00:00:00+00:00,134037,6042
696.9268823235674,6195.225190731398,143523,219476213.7813369,314920,2024-09-30 00:00:00+00:00,138326,5197
392.50279026124116,6015.466010656665,125931,121366965.28505234,309213,2024-10-01 00:00:00+00:00,120535,5396
429.952376398807,5089.669158373512,131308,127282241.60435213,296038,2024-10-02 00:00:00+00:00,124834,6474
523.8875628205963,6066.400474104721,145972,170787869.3670312,326001,2024-10-03 00:00:00+00:00,139662,6310
324.08444004852737,6318.050190271247,186776,131556244.91778421,405932,2024-10-04 00:00:00+00:00,181133,5643
612.9921181200018,7298.244185866368,134924,191852434.15283656,312977,2024-10-05 00:00:00+00:00,128413,6511
337.25508344114036,6306.834694186417,150488,109939086.61030613,325982,2024-10-06 00:00:00+00:00,144645,5843
260.6775543596859,5800.93593753273,173234,92485268.15617663,354788,2024-10-07 00:00:00+00:00,165580,7654
141.01600732597524,4481.205828965658,177644,47392377.71010454,336078,2024-10-08 00:00:00+00:00,171443,6201
164.03194672840743,4836.425606299842,225904,67356602.31704195,410631,2024-10-09 00:00:00+00:00,219427,6477
267.16453984341547,5300.399839760679,193203,98758173.6467647,369653,2024-10-10 00:00:00+00:00,187034,6169
808.9002391569267,6605.5271238252035,100646,239284824.24624437,295815,2024-10-11 00:00:00+00:00,94744,5902
420.34004441494966,4365.989533484291,156849,133518493.06797102,317644,2024-10-12 00:00:00+00:00,151237,5612
347.5385673243077,4952.675086000523,156680,111553971.95539656,320983,2024-10-13 00:00:00+00:00,150713,5967
871.6470493223944,4434.879515374446,243307,361874732.2903024,415162,2024-10-14 00:00:00+00:00,236355,6952
667.3601256993646,5065.084457472645,90511,181085500.6680189,271346,2024-10-15 00:00:00+00:00,83238,7273
1024.5804545841336,9152.085479650706,117745,328909792.95014954,321019,2024-10-16 00:00:00+00:00,111522,6223
577.8777580422546,5599.036496866274,101780,173136221.4537673,299607,2024-10-17 00:00:00+00:00,96808,4972
940.9017795514047,7598.832660477437,84186,355412474.6006345,377736,2024-10-18 00:00:00+00:00,79227,4959
342.2398239090666,5599.741925464936,258628,158491604.69215655,463101,2024-10-19 00:00:00+00:00,253854,4774
171.32816314200778,4771.735876585961,169303,63015526.372628875,367806,2024-10-20 00:00:00+00:00,165477,3826
436.2506906986382,5215.883644289586,163935,171378466.33681384,392844,2024-10-21 00:00:00+00:00,159387,4548
716.0537114516693,6661.756544666855,156735,290873190.5047718,406217,2024-10-22 00:00:00+00:00,148174,8561
324.36776125394437,11502.453221888085,236069,162119655.8102443,499802,2024-10-23 00:00:00+00:00,231899,4170
369.44614595567316,210262.60096386194,197927,182079316.35737985,492844,2024-10-24 00:00:00+00:00,192344,5583
272.7042277115078,7997.518241201118,209736,152624920.5317554,559672,2024-10-25 00:00:00+00:00,205850,3886
219.1248401489455,8010.516723791845,245464,131106336.10823587,598318,2024-10-26 00:00:00+00:00,240977,4487
263.10192386666887,7378.073742162879,111866,119704271.6073862,454973,2024-10-27 00:00:00+00:00,107799,4067
206.18819811991347,7754.114776088774,255715,128141841.36756454,621480,2024-10-28 00:00:00+00:00,251267,4448
119.49396320348822,7199.130765879216,254302,76688955.1986988,641781,2024-10-29 00:00:00+00:00,249709,4593
353.09041126614557,8241.152995765975,265402,242836164.8962407,687745,2024-10-30 00:00:00+00:00,260663,4739
1136.673552026572,27771.611008150627,362761,1054459090.6820482,927671,2024-10-31 00:00:00+00:00,356282,6479
463.4515573789261,14707.103712366803,210205,338543483.98883355,730483,2024-11-01 00:00:00+00:00,205419,4786
259.57778620712116,6023.539936810806,189326,112350976.5817349,432822,2024-11-02 00:00:00+00:00,186042,3284
277.3317351411125,7233.683185734548,226458,123006885.8092821,443537,2024-11-03 00:00:00+00:00,223633,2825
423.88447009575737,9155.503991758136,183711,262505294.06324872,619285,2024-11-04 00:00:00+00:00,180841,2870
217.88969446954445,9349.58645692266,279169,175733050.05268663,806523,2024-11-05 00:00:00+00:00,276265,2904
310.4407187028357,14493.351768170414,445715,280775934.94589245,904443,2024-11-06 00:00:00+00:00,442739,2976
126.41081824913806,9371.836158224905,426729,110779741.34024341,876347,2024-11-07 00:00:00+00:00,423862,2867
216.5372418703504,9633.00931414593,415647,182118214.2006864,841048,2024-11-08 00:00:00+00:00,412580,3067
89.27192279207316,9096.260845933693,397830,72117430.10837948,807840,2024-11-09 00:00:00+00:00,394629,3201
251.34410097726416,9660.236791039322,295938,143076624.10493907,569246,2024-11-10 00:00:00+00:00,292570,3368
420.7613133524354,9888.431020931926,208221,187600218.41000226,445859,2024-11-11 00:00:00+00:00,204090,4131
515.7216779957225,11816.763274851091,173653,246385000.21909845,477748,2024-11-12 00:00:00+00:00,169547,4106
457.22411655297395,13718.89978111295,370306,316298499.34914815,691780,2024-11-13 00:00:00+00:00,366557,3749
254.67394219428326,11524.338913139338,421162,186233630.9908828,731263,2024-11-14 00:00:00+00:00,417663,3499
265.6356361122048,9987.974685186835,311632,165667383.36028233,623664,2024-11-15 00:00:00+00:00,308020,3612
352.7330578856722,11983.903039814973,177952,172604983.6135424,489336,2024-11-16 00:00:00+00:00,174160,3792
355.4676282911739,10640.198251475402,196009,185553391.03273594,521998,2024-11-17 00:00:00+00:00,192435,3574
328.5490156280909,9544.661026942766,134209,161215387.92953175,490689,2024-11-18 00:00:00+00:00,129777,4432
648.2139469783169,18529.646281434645,362151,486707552.8050392,750844,2024-11-19 00:00:00+00:00,357757,4394
283.56886610779446,8959.243665932598,395885,216983209.95056137,765187,2024-11-20 00:00:00+00:00,390963,4922
252.29669868760436,8923.424183280054,351253,178506978.62906948,707528,2024-11-21 00:00:00+00:00,342598,8655
572.8842662971866,11478.934644958297,184552,302944064.4393316,528805,2024-11-22 00:00:00+00:00,180094,4458
624.594660860337,10471.831956903483,129297,297748022.4000886,476706,2024-11-23 00:00:00+00:00,124686,4611
941.5045487940615,16540.29872156304,162550,552607621.3737384,586941,2024-11-24 00:00:00+00:00,158028,4522
544.0132235820303,9101.150414185637,182185,298225873.114773,548196,2024-11-25 00:00:00+00:00,177835,4350
429.38811031524955,6455.437001246354,101531,193192016.14547724,449924,2024-11-26 00:00:00+00:00,97751,3780
575.9055662551609,8387.005703174138,117858,223988103.694751,388932,2024-11-27 00:00:00+00:00,112842,5016
892.7072352530527,5295.177431278411,158321,349671638.6341479,391698,2024-11-28 00:00:00+00:00,153181,5140
901.9569007832586,6729.829393052552,120359,329358581.8900146,365160,2024-11-29 00:00:00+00:00,115957,4402
371.34627494481254,5994.940553683328,225242,162866534.65039614,438584,2024-11-30 00:00:00+00:00,221423,3819
855.6068614508375,13922.062900230727,238812,435332771.10618675,508800,2024-12-01 00:00:00+00:00,234421,4391
1482.6647659228208,31369.635156018823,222846,863545474.2869109,582428,2024-12-02 00:00:00+00:00,215995,6851
1942.1040446143593,28672.009214224767,235900,1266220763.4238772,651984,2024-12-03 00:00:00+00:00,229594,6306
902.0952726181906,8275.112611105882,109188,353816199.44521725,392216,2024-12-04 00:00:00+00:00,103885,5303
797.8514172016542,7228.1330169331195,100008,333743641.3696951,418303,2024-12-05 00:00:00+00:00,95408,4600
723.0277507679823,7971.3484478554365,111155,335947614.11682564,464640,2024-12-06 00:00:00+00:00,107009,4146
1004.2025740681026,7078.392328396788,109564,466915033.04127353,464961,2024-12-07 00:00:00+00:00,105739,3825
391.7678667605932,5181.367663153214,100191,154954769.0362172,395527,2024-12-08 00:00:00+00:00,96686,3505
712.6109714031431,6719.391867066395,143989,305620317.74955004,428874,2024-12-09 00:00:00+00:00,140090,3899
592.9109595294344,6149.872195852086,151267,273547179.02137953,461363,2024-12-10 00:00:00+00:00,146181,5086
596.6108778402607,5690.102168128997,238404,322696084.8279983,540882,2024-12-11 00:00:00+00:00,233995,4409
358.47718302899256,4496.050639950174,245675,199679318.96803144,557021,2024-12-12 00:00:00+00:00,241751,3924
218.7167647048375,4560.381919833894,451993,165758655.7501944,757869,2024-12-13 00:00:00+00:00,448551,3442
279.6080339433621,6057.772101077665,443033,212475263.4258143,759904,2024-12-14 00:00:00+00:00,439463,3570
512.2121627151228,8632.660758678772,457838,404777710.43444115,790254,2024-12-15 00:00:00+00:00,454122,3716
301.3721727849676,5102.709687311937,443271,223437630.27504015,741401,2024-12-16 00:00:00+00:00,439101,4170
468.5530129868992,4382.3713857793255,257965,270025227.1723314,576296,2024-12-17 00:00:00+00:00,253838,4127
344.5154942035823,5154.473532327386,286759,196065834.84429863,569106,2024-12-18 00:00:00+00:00,281423,5336
419.6882155770018,5675.025886844462,211460,226962770.41365027,540789,2024-12-19 00:00:00+00:00,206178,5282
532.1540195865381,6639.872138168518,185471,237529075.25852907,446354,2024-12-20 00:00:00+00:00,181187,4284
227.2902503437735,3906.8069102307486,130108,75715382.77501923,333122,2024-12-21 00:00:00+00:00,126843,3265
243.15651415234547,4261.075503616859,203868,98270732.56861426,404146,2024-12-22 00:00:00+00:00,198524,5344
218.01566628767748,3674.2196515851024,187163,85072983.22044681,390215,2024-12-23 00:00:00+00:00,183693,3470
260.04367699083656,3488.7542661504963,264432,150623278.71766073,579223,2024-12-24 00:00:00+00:00,259680,4752
153.0842576269339,3616.4156171253107,529250,110848310.94762798,724100,2024-12-25 00:00:00+00:00,525637,3613
204.4979038102936,4674.847939471115,334099,114945204.26322548,562085,2024-12-26 00:00:00+00:00,330380,3719
213.01828096278334,4307.580377767143,398078,125150796.28503887,587512,2024-12-27 00:00:00+00:00,394556,3522
61.21355066090433,3224.0872152507677,288751,32080981.27101557,524083,2024-12-28 00:00:00+00:00,285292,3459
93.11986458193803,3281.3171238672785,295282,44718021.3695507,480220,2024-12-29 00:00:00+00:00,292412,2870
839.7597557268352,3918.779039607083,102996,270726788.6097525,322386,2024-12-30 00:00:00+00:00,99232,3764
468.93584136772085,5402.702661939056,94382,148904011.32454035,317536,2024-12-31 00:00:00+00:00,91191,3191
482.98526999519413,4678.1560653252955,84447,147730704.5334235,305870,2025-01-01 00:00:00+00:00,81235,3212
215.37276191894844,3978.63722842246,103763,71271369.7469815,330921,2025-01-02 00:00:00+00:00,100512,3251
202.38044451443858,3586.3236371114017,97519,62697056.94968489,309798,2025-01-03 00:00:00+00:00,94338,3181
107.63549214461902,3832.2738120565486,100577,35184750.7561704,326888,2025-01-04 00:00:00+00:00,97494,3083
108.59307710816474,3629.2813548274557,72229,28829833.076061334,265485,2025-01-05 00:00:00+00:00,69202,3027
189.16237919805567,5098.178622267769,110505,69339172.55646122,366559,2025-01-06 00:00:00+00:00,106877,3628
204.97272181947108,6446.031594690785,108798,69029688.39075269,336775,2025-01-07 00:00:00+00:00,104622,4176
314.55466752862816,7353.919751291234,138467,146576183.9749916,465980,2025-01-08 00:00:00+00:00,134592,3875
93.88493881296802,6724.277171546794,369794,88561099.47264126,943294,2025-01-09 00:00:00+00:00,366163,3631
177.53660160985905,6435.625119082914,239581,98636140.19558224,555582,2025-01-10 00:00:00+00:00,236015,3566
172.87179010022996,4626.8227534716125,89756,45038460.346603565,260531,2025-01-11 00:00:00+00:00,86546,3210
242.04288756946414,4367.677188402787,82848,64240602.78981257,265410,2025-01-12 00:00:00+00:00,79693,3155
238.48421886830485,8809.048906942164,121172,76051424.97600915,318895,2025-01-13 00:00:00+00:00,117627,3545
294.6981897057452,5609.150173613691,80613,81327270.01671505,275968,2025-01-14 00:00:00+00:00,77123,3490
211.1263085183716,8141.772036873071,96356,93592503.69250675,443301,2025-01-15 00:00:00+00:00,90527,5829
332.8552236666415,6822.052547553043,93069,160218863.34626433,481347,2025-01-16 00:00:00+00:00,86566,6503
377.02453838533563,4273.893443726637,111358,129254945.4701066,342829,2025-01-17 00:00:00+00:00,107600,3758
382.07008813310415,3553.5169201777007,63803,97319746.63900141,254717,2025-01-18 00:00:00+00:00,60227,3576
249.9573888338929,4350.76118415363,80481,79880132.53659353,319575,2025-01-19 00:00:00+00:00,77122,3359
494.83089745165097,4668.075067526245,111972,177104926.50691938,357910,2025-01-20 00:00:00+00:00,108013,3959
429.00415306221487,3692.0861868244474,87156,130417262.53091218,304000,2025-01-21 00:00:00+00:00,82225,4931
193.80894383033558,3756.6155332951444,221836,99086179.19585419,511257,2025-01-22 00:00:00+00:00,140519,81317
148.2621253755301,3859.6823651393506,277485,89123180.54361467,601119,2025-01-23 00:00:00+00:00,185575,91910
166.08254994441043,3702.6475441609327,221326,83096414.37877782,500332,2025-01-24 00:00:00+00:00,166458,54868
53.00495245442811,3500.09516633243,392644,35202709.1230924,664140,2025-01-25 00:00:00+00:00,311987,80657
64.95105632723711,3568.3301149286,348808,42723960.48832667,657787,2025-01-26 00:00:00+00:00,214351,134457
238.8353383114211,4945.794641965774,408274,200478860.64928806,839402,2025-01-27 00:00:00+00:00,279278,128996
54.79276082087883,4297.307588744967,610533,55749606.80308649,1017463,2025-01-28 00:00:00+00:00,472579,137954
37.29653025074867,3716.7614334820178,580388,39630882.782616384,1062589,2025-01-29 00:00:00+00:00,417699,162689
48.07771794510278,3585.7261674908605,522333,46931737.4601678,976164,2025-01-30 00:00:00+00:00,333165,189168
37.453278264526695,4512.2178450241245,627707,46577758.27518577,1243623,2025-01-31 00:00:00+00:00,410294,217413
52.479934204774096,4820.666602081014,704983,76898900.07018228,1465301,2025-02-01 00:00:00+00:00,438007,266976
143.80585667804374,5497.330099576851,718494,188396026.2698749,1310072,2025-02-02 00:00:00+00:00,426281,292213
319.737371034916,12859.97014513231,861108,481263894.82109684,1505185,2025-02-03 00:00:00+00:00,628778,232330
132.15749094600486,4637.437450725494,531847,133907520.44111584,1013242,2025-02-04 00:00:00+00:00,338385,193462
111.3417097401429,4518.522782843437,584057,102603278.33460703,921517,2025-02-05 00:00:00+00:00,348498,235559
97.1757242556829,3842.6750220214794,375238,65621892.00835788,675291,2025-02-06 00:00:00+00:00,248438,126800
97.66778907911836,4965.159348932438,570935,105135663.56770061,1076462,2025-02-07 00:00:00+00:00,328726,242209
75.15014003143295,4037.2941452573814,572907,75384683.61848295,1003121,2025-02-08 00:00:00+00:00,292849,280058
54.58891843639578,3619.4929348835003,470502,45044318.9923881,825155,2025-02-09 00:00:00+00:00,306255,164247
96.21762185565939,4900.238855614534,606545,101937085.95166142,1059443,2025-02-10 00:00:00+00:00,361925,244620
65.1359880986654,4676.351057934711,616732,67254210.43163589,1032520,2025-02-11 00:00:00+00:00,382518,234214
72.26812699937275,3279.420569158362,613597,64972442.77440962,899047,2025-02-12 00:00:00+00:00,354756,258841
182.3134480236985,3259.4150495687736,698487,172618930.4250318,946825,2025-02-13 00:00:00+00:00,405745,292742
79.97994940297235,3811.777313907604,679383,75614403.82470849,945417,2025-02-14 00:00:00+00:00,380034,299349
49.81999340081687,3445.045396532824,711887,46578455.5302014,934935,2025-02-15 00:00:00+00:00,431196,280691
63.06886338834957,2793.748478808803,394544,38030839.967493735,603005,2025-02-16 00:00:00+00:00,262088,132456
146.08714528821062,5858.86922613728,372196,83197359.67736422,569505,2025-02-17 00:00:00+00:00,286561,85635
184.86775891699,3578.4693252315265,319290,92188744.81016241,498674,2025-02-18 00:00:00+00:00,222085,97205
143.22625426570065,3479.7440588793884,281026,83521674.04378085,583145,2025-02-19 00:00:00+00:00,205538,75488
115.93433713972071,3971.652673998302,357125,63907759.93923748,551241,2025-02-20 00:00:00+00:00,312945,44180
171.8109552333797,6052.24402710388,393167,105834689.36898904,615995,2025-02-21 00:00:00+00:00,310135,83032
104.93818363900995,5445.619390017024,479730,76379991.52893834,727857,2025-02-22 00:00:00+00:00,368524,111206
219.48463932969736,6971.290143854498,469774,173214204.57406148,789186,2025-02-23 00:00:00+00:00,402979,66795
125.56330291362838,4783.990312972532,473656,91679417.80587095,730145,2025-02-24 00:00:00+00:00,414275,59381
205.23075173001513,5743.638808458371,546589,164464330.89862013,801363,2025-02-25 00:00:00+00:00,462130,84459
147.37590329244577,4083.5486489567716,399119,102326774.05352828,694325,2025-02-26 00:00:00+00:00,325861,73258
99.24425391889396,3765.2829640550067,482986,74279064.11284418,748447,2025-02-27 00:00:00+00:00,425608,57378
226.5584035809015,5214.451100478505,339566,140496569.04625264,620134,2025-02-28 00:00:00+00:00,280163,59403
127.92229785222968,3548.245662085346,455186,87984828.54047517,687799,2025-03-01 00:00:00+00:00,231276,223910
100.26635391073786,5809.907326420624,575907,81305685.58715582,810897,2025-03-02 00:00:00+00:00,392612,183295
154.56932710768956,6055.515798604154,570811,130356969.43223181,843356,2025-03-03 00:00:00+00:00,482255,88556
182.9452208667086,5755.2385003509935,473560,139124169.16728994,760469,2025-03-04 00:00:00+00:00,422586,50974
439.1607832358555,3303.292663149636,417293,303966014.4383156,692152,2025-03-05 00:00:00+00:00,353862,63431
145.38808925811216,6166.7642327542035,637899,152638157.10514474,1049867,2025-03-06 00:00:00+00:00,545934,91965
117.40065212039201,5358.227259053625,656529,134119913.79013667,1142412,2025-03-07 00:00:00+00:00,421574,234955
64.5329930096317,5143.608625778464,593540,67107214.10078244,1039890,2025-03-08 00:00:00+00:00,392848,200692
115.66010888661533,6904.895651231378,537364,176257331.4350228,1523925,2025-03-09 00:00:00+00:00,398779,138585
88.36056495604456,7548.902923657734,743505,134976241.3253825,1527562,2025-03-10 00:00:00+00:00,598338,145167
53.1787067969476,7972.472462808848,729075,117506223.11646034,2209648,2025-03-11 00:00:00+00:00,638312,90763
31.995279676997555,757.4151653496002,108985,6466917.9235944245,202121,2025-03-12 00:00:00+00:00,91053,17932
